-1 6 2 3 4 3 4 5 5 
2 6 8 9 2 4 3 5 6 
5 3 5 9 2 -1 4 4 6 
5 2 8 4 5 4 4 5 6 
5 6 4 -1 2 3 3 5 6 
5 -1 8 9 5 5 4 5 6 
5 3 4 -1 2 3 6 5 6 
5 6 3 7 5 2 4 5 4 
5 6 8 5 3 3 -1 -1 6 
4 6 8 9 2 8 2 5 3 